#######...#########...######## 
#............................# 
#............................# 
#............................# 
#....bbbp....................#
#............................. 
#.............................
#............................# 
#............................# 
#............................# 
#.............................
#............................# 
#............................#
.............................. 
.............................. 
.............................. 
..............................
.............................. 
..............................
.............................. 
.............................. 
.............................. 
..............................
.............................. 
..............................
#............................# 
#............................#
#............................# 
#............................#
#######...#########...######## 